EEEWWWWEWEWW
WWWWEWWWEEEE
EWEWEWWWEEWE
WWWWWDEEWEEW
EWEEWWWEEEWW
EWWWEEEWEAEW
EWEWEEEWWEEE
EWWEWEWEEEWE
EWWEEEWWEWEW
EWEWEEEWWWEE
EWWEWEEEEEWE
WWWEEEWEEWWE
